xxxxxxxxxxxxxxxxxxxx
x             x    x
x             x    x
x             x    x
x                  x
x  xxxxx           x
x      xo          x
x      x           x
x  +   x           x
x      x           x
xxxxxxxxxxxxxxxxxxxx
